WWWWWWWWWWWWWWWWWWWWWWWWWWWW
W__________________________W
W__________________________W
W_____________________2____W
W____WDWWDWWDWWWWWWWWWW____W
W____________D___________3_W
W____________D_____________W
W____________D_____________W
W__0__________D____________W
W_____________D____________W
W_____________D__________3_W
W____WWWWWWWWWWDWWDWWDW____W
W__________________________W
W_____________________2____W
W__________________________W
WWWWWWWWWWWWWWWWWWWWWWWWWWWW