WWWWWWWWWWWWWWWWWWWWWWWWWWWW
W___D___W___D___W___D___D__W
W___W___D___W___D___W___D__W
W___D__5W___D___W__4D___D_7W
W___W___D__6W___D___W___D__W
W___D___W___D___W___D___D__W
W___W___D___W___D___W___D__W
W___D___W___D___W___D___D__W
W0__W___D___W__3D___W___D__W
W___D___W__6D___W___D___D__W
W___W___D___W___D___W__4D__W
W___D___W___D___W___D___D__W
W___W___D___W___D___W___D_7W
W___D__5W___D___W___D___D__W
W___W___D___W___D___W___D__W
WWWWWWWWWWWWWWWWWWWWWWWWWWWW