WWWWWWWWWWWWWWWWWWWWWWWWWWWW
W__________________________W
W__________________________W
W__________________________W
W___WWWW____________WWWW___W
W___W__________________W___W
W___W__________________W___W
W__________________________W
W____________0_____________W
W___W__________________W___W
W___W__________________W___W
W___WWWW____________WWWW___W
W__________________________W
W__________________________W
W__________________________W
WWWWWWWWWWWWWWWWWWWWWWWWWWWW