WWWWWWWWWWWWWWWWWWWWWWWWWWWW
W__________________________W
W__________________________W
W_______________________2__W
W____WWWWWWWWWWDDDDDD______W
W____WWWWWWWWWWDDDDDD______W
W__________________________W
W__________________________W
W__________________________W
W__________________________W
W______DDDDDDWWWWWWWWWW____W
W______DDDDDDWWWWWWWWWW____W
W__________________________W
W__0_______________________W
W__________________________W
WWWWWWWWWWWWWWWWWWWWWWWWWWWW