WWWWWWWWWWWWWWWWWWWWWWWWWWWW
W__________________________W
W_________________________3W
W____W_____DWDDWD_____W____W
W____W________________W____W
W____WW_____________5WW____W
W_____W______________W_____W
W_____D______________D___6_W
W_0___D______________D_____W
W_____W______________W_____W
W____WW_____________5WW____W
W____W________________W____W
W____W_____DWDDWD_____W____W
W_________________________3W
W__________________________W
WWWWWWWWWWWWWWWWWWWWWWWWWWWW