WWWWWWWWWWWWWWWWWWWWWWWWWWWW
W__________________________W
W____________________3_____W
W______________________W___W
W______________________WW__W
W__________________________W
W________________________3_W
W__________________________W
W__________________________W
W__________________________W
W__________________________W
W__WW______________________W
W__0W______________________W
W__________________________W
W__________________________W
WWWWWWWWWWWWWWWWWWWWWWWWWWWW