WWWWWWWWWWWWWWWWWWWWWWWWWWWW
W__________________________W
W__________________________W
W__________________________W
W____WW_______WW___________W
W____WW_______WW___________W
W____WW_______WW___________W
W_____________DD___________W
W__0__________DD_______1___W
W____WW_______WW___________W
W____WW_______WW___________W
W____WW_______WW___________W
W__________________________W
W__________________________W
W__________________________W
WWWWWWWWWWWWWWWWWWWWWWWWWWWW