WWWWWWWWWWWWWWWWWWWWWWWWWWWW
W__________________________W
W_______________________3__W
W___WWWWWWWWWWWWWWWWWWWW___W
W____________4_____________W
W____W__D__W__D__W__D______W
W____W__D__W__D__W__D______W
W______________________4___W
W______D__W__D__W__D__W____W
W______D__W__D__W__D__W____W
W__0_______________________W
W__________________________W
W___WWWWWWWWWWWWWWWWWWWW___W
W_______________________3__W
W__________________________W
WWWWWWWWWWWWWWWWWWWWWWWWWWWW