WWWWWWWWWWWWWWWWWWWWWWWWWWWW
W__________________________W
W__________________________W
W__________________________W
W___wwww____________wwww___W
W___w__________________w___W
W___w__________________w___W
W__________________________W
W____________0_____________W
W___w__________________w___W
W___w__________________w___W
W___wwww____________wwww___W
W__________________________W
W__________________________W
W__________________________W
WWWWWWWWWWWWWWWWWWWWWWWWWWWW