WWWWWWWWWWWWWWWWWWWWWWWWWWWW
W________D________D________W
W________W____1___W_____2__W
W________D________D________W
W________W_________________W
WDWDWDWD_D_WDWDWDWDWDWDWDWDW
W________W_________________W
W________D________W________W
W________W____2___D_____1__W
W_________________W________W
WDWDWDWDWDWDWDWDW_D_DWDWDWDW
W_________________W________W
W________D________D________W
W__0_____W________W________W
W________D________D________W
WWWWWWWWWWWWWWWWWWWWWWWWWWWW