WWWWWWWWWWWWWWWWWWWWWWWWWWWW
W__________________________W
W__________________________W
W_____D_______________D____W
W___3_D_______________D_3__W
W_____D__DDDDDDDDDDD__D____W
W__DDDW__W_________W__WDDD_W
W________W__1______W_______W
W________W______1__W_______W
W__DDDW__W_________W__WDDD_W
W_____D__DDDDDDDDDDD__D____W
W_____D_______________D_3__W
W_____D_______________D____W
W__________________________W
W_0________________________W
WWWWWWWWWWWWWWWWWWWWWWWWWWWW