WWWWWWWWWWWWWWWWWWWWWWWWWWWW
W_4________________________W
W__________________________W
WWWWWWWWWWWW_______________W
W__________________________W
W_3______________WWWWWWWWWWW
W__________________________W
WWWWWWWWWWWW__________3____W
W__________________________W
W________________WWWWWWWWWWW
W__________________________W
WWWWWWWWWWWW_______________W
W_____________________4____W
W__0_______________________W
W__________________________W
WWWWWWWWWWWWWWWWWWWWWWWWWWWW