WWWWWWWWWWWWWWWWWWWWWWWWWWWW
W________W_________________W
W________W_________________W
W_0______W_7___WWWWWW______W
W________W__________W______W
W________W__________W__6___W
W______WWW_______5__W______W
W______W____________W______W
W______W____________W______W
W______W__5_______WWW______W
W______W__________W________W
W______W__________W________W
W______WWWWWW_____W__7_____W
W_________4_______W________W
W_________________W________W
WWWWWWWWWWWWWWWWWWWWWWWWWWWW