WWWWWWWWWWWWWWWWWWWWWWWWWWWW
W__________________________W
W_____2____________________W
W___WWDDDDDDDWW____________W
W___WWDDDDDDDWW____________W
W_____________W____________W
W_____________W____________W
W____________WW____________W
W__0_________WW________1___W
W____________W_____________W
W____________W_____________W
W____________WWDDDDDDDWW___W
W____________WWDDDDDDDWW___W
W__________________________W
W______________________2___W
WWWWWWWWWWWWWWWWWWWWWWWWWWWW